20
 --------------------------------------------------
-----  ************--*********-----************----
-----  *-----------------*--------------*----------
-----  *-----------------*--------------*----------
-----  *-----------------*--------------*----------
-----  *-----------------*--------------*----------
-----  ******------------*--------------*----------
------ *-----------------*--------------*----------
------ *-----------------*--------------*----------
------ *-----------------*--------------*----------
------ *-----------------*--------------*----------
------ *-------------*********----------*----------
 --------------------------------------------------
 --------------------------------------------------
 ---********************************************---
 ----------------*****************-----------------
 --------------------------------------------------
 --------------------------------------------------
 --------------------------------------------------
 --------------------------------------------------



